222222222222222
211111111111112
212122202221212
212010101010212
212122212221212
211111111111112
212122212221212
212010101010212
212122202221212
211111111111112
222222222222222