222222202222222
211111111111112
212122202221212
212010101010212
212121111121212
101010101010101
212122111221212
212010101010212
212122202221212
211111111111112
222222202222222